{
  "levelName": "The Gauntlet",
  "width": 8,
  "height": 8,
  "tiles": [
    1, 1, 1, 1, 1, 1, 1, 1,
    1, 0, 0, 1, 0, 0, 0, 1,
    1, 0, 0, 0, 0, 1, 0, 1,
    1, 1, 0, 1, 0, 0, 0, 1,
    1, 0, 0, 0, 1, 0, 1, 1,
    1, 0, 1, 0, 0, 0, 0, 1,
    1, 2, 0, 2, 0, 2, 0, 1,
    1, 1, 1, 1, 1, 1, 1, 1
  ],
  "playerStart": [1, 1],
  "boxPositions": [
    [2, 1],
    [4, 2],
    [6, 3]
  ],
  "parMoves": 20
}
